1111111
1E00001
1C00001
1000P01
1000E01
1111111