1111111111111
10P0000000001
10000C0C01C01
100000CC01E01
1000000000001
1000000000001
1000000000001
1000000000001
1000000000011
1111111111111